Polling Station,Electors,Total votes,Valid votes,Invalid votes,Voter Turnout
Sum,223525,151040,149952,1088,67.57%
1387,1027,664,662,2,64.65%
1388,993,635,634,1,63.95%
1389,1065,715,711,4,67.14%
1390,1058,740,739,1,69.94%
1391,1333,933,929,4,69.99%
1392,1204,795,793,2,66.03%
1393,1406,975,972,3,69.35%
1394,1141,787,784,3,68.97%
1395,1343,942,938,4,70.14%
1396,1223,853,845,8,69.75%
1397,1297,895,891,4,69.01%
1398,1106,738,731,7,66.73%
1399,1138,784,779,5,68.89%
1400,1324,907,899,8,68.50%
1401,1242,826,817,9,66.51%
1402,1279,846,844,2,66.15%
1403,1010,665,659,6,65.84%
1404,986,599,594,5,60.75%
1405,967,646,639,7,66.80%
1406,818,510,508,2,62.35%
1407,827,571,570,1,69.04%
1408,1207,843,839,4,69.84%
1409,1113,772,766,6,69.36%
1410,1143,780,776,4,68.24%
1411,1396,919,909,10,65.83%
1412,1261,864,857,7,68.52%
1413,1419,935,931,4,65.89%
1414,1151,764,757,7,66.38%
1415,1315,854,848,6,64.94%
1416,1124,770,763,7,68.51%
1417,1100,738,731,7,67.09%
1418,1012,660,656,4,65.22%
1419,984,670,665,5,68.09%
1420,1064,653,647,6,61.37%
1421,1268,856,852,4,67.51%
1422,1125,757,751,6,67.29%
1423,1093,695,691,4,63.59%
1424,1124,713,707,6,63.43%
1425,970,645,644,1,66.49%
1426,1155,783,777,6,67.79%
1427,1155,809,804,5,70.04%
1428,976,653,652,1,66.91%
1429,1202,778,772,6,64.73%
1430,1285,863,858,5,67.16%
1431,1240,842,837,5,67.90%
1432,1051,720,709,11,68.51%
1433,1187,843,837,6,71.02%
1434,1026,728,725,3,70.96%
1435,1131,760,753,7,67.20%
1436,1129,784,777,7,69.44%
1437,1122,804,800,4,71.66%
1438,1144,790,780,10,69.06%
1439,1162,774,767,7,66.61%
1440,2455,719,708,11,29.29%
1441,1127,736,729,7,65.31%
1442,1209,857,845,12,70.89%
1443,1329,947,942,5,71.26%
1444,980,681,681,0,69.49%
1445,1215,858,849,9,70.62%
1446,1073,742,741,1,69.15%
1447,1169,754,749,5,64.50%
1448,1160,744,739,5,64.14%
1449,1152,741,734,7,64.32%
1450,1195,783,780,3,65.52%
1451,1104,747,740,7,67.66%
1452,900,646,638,8,71.78%
1453,878,617,612,5,70.27%
1454,967,658,656,2,68.05%
1455,1374,951,943,8,69.21%
1456,1438,1011,1005,6,70.31%
1457,1399,974,969,5,69.62%
1458,1406,1006,998,8,71.55%
1459,940,646,642,4,68.72%
1460,1054,773,770,3,73.34%
1461,1112,780,777,3,70.14%
1462,1176,787,785,2,66.92%
1463,1234,811,808,3,65.72%
1464,1371,934,927,7,68.13%
1465,1276,872,869,3,68.34%
1466,1323,926,920,6,69.99%
1467,1246,871,865,6,69.90%
1468,1295,928,926,2,71.66%
1469,1301,925,921,4,71.10%
1470,1282,966,965,1,75.35%
1471,1443,979,968,11,67.84%
1472,1287,930,922,8,72.26%
1473,1203,824,816,8,68.50%
1474,1197,848,842,6,70.84%
1475,1194,800,794,6,67.00%
1476,1275,884,879,5,69.33%
1477,1285,899,894,5,69.96%
1478,1218,863,858,5,70.85%
1479,1234,879,869,10,71.23%
1480,1348,863,857,6,64.02%
1481,1319,785,775,10,59.51%
1482,1280,832,822,10,65.00%
1483,1098,709,707,2,64.57%
1484,966,661,657,4,68.43%
1485,1038,697,693,4,67.15%
1486,1041,663,656,7,63.69%
1487,1237,849,837,12,68.63%
1488,1246,828,821,7,66.45%
1489,1251,837,831,6,66.91%
1490,1197,788,781,7,65.83%
1491,1015,723,712,11,71.23%
1492,930,659,650,9,70.86%
1493,1184,786,780,6,66.39%
1494,1120,802,795,7,71.61%
1495,1211,803,791,12,66.31%
1496,1134,759,756,3,66.93%
1497,990,648,646,2,65.45%
1498,1081,777,773,4,71.88%
1499,1287,925,918,7,71.87%
1500,1136,793,786,7,69.81%
1501,1099,754,748,6,68.61%
1502,1153,810,806,4,70.25%
1503,1083,733,727,6,67.68%
1504,1192,833,828,5,69.88%
1505,990,683,681,2,68.99%
1506,1184,808,801,7,68.24%
1507,1024,695,691,4,67.87%
1508,1072,774,766,8,72.20%
1509,970,725,723,2,74.74%
1510,1065,748,745,3,70.23%
1511,1184,862,856,6,72.80%
1512,1149,786,781,5,68.41%
1513,1283,902,895,7,70.30%
1514,688,485,481,4,70.49%
1515,877,580,577,3,66.13%
1516,798,535,531,4,67.04%
1517,763,542,540,2,71.04%
1518,1245,847,837,10,68.03%
1519,1170,810,803,7,69.23%
1520,1020,703,701,2,68.92%
1521,1153,743,738,5,64.44%
1522,1099,744,737,7,67.70%
1523,1128,808,796,12,71.63%
1524,1107,735,724,11,66.40%
1525,988,673,669,4,68.12%
1526,1124,795,788,7,70.73%
1527,1377,984,977,7,71.46%
1528,1259,850,849,1,67.51%
1529,1267,894,886,8,70.56%
1530,1315,891,887,4,67.76%
1531,1253,892,888,4,71.19%
1532,1246,854,844,10,68.54%
1533,1062,712,707,5,67.04%
1534,1160,755,747,8,65.09%
1535,1163,759,753,6,65.26%
1536,1225,852,848,4,69.55%
1537,1033,716,712,4,69.31%
1538,954,682,670,12,71.49%
1539,1218,816,805,11,67.00%
1540,1294,926,922,4,71.56%
1541,1231,853,845,8,69.29%
1542,1207,832,827,5,68.93%
1543,1186,816,811,5,68.80%
1544,1213,834,825,9,68.76%
1545,1345,905,898,7,67.29%
1546,1192,812,806,6,68.12%
1547,1273,898,893,5,70.54%
1548,1216,785,778,7,64.56%
1549,1216,826,818,8,67.93%
1550,1195,775,770,5,64.85%
1551,1057,629,623,6,59.51%
1552,1181,788,778,10,66.72%
1553,1143,718,715,3,62.82%
1554,1146,726,720,6,63.35%
1555,1126,727,722,5,64.56%
1556,1198,818,814,4,68.28%
1557,1127,713,710,3,63.27%
1558,1175,779,774,5,66.30%
1559,1122,754,750,4,67.20%
1560,1217,831,823,8,68.28%
1561,1126,762,753,9,67.67%
1562,1080,721,719,2,66.76%
1563,1156,732,727,5,63.32%
1564,1126,781,781,0,69.36%
1565,1158,749,742,7,64.68%
1566,1156,776,769,7,67.13%
1567,1009,622,617,5,61.65%
1568,981,670,667,3,68.30%
1569,1129,750,747,3,66.43%
1570,1144,761,757,4,66.52%
1571,1185,834,830,4,70.38%
1572,1208,796,794,2,65.89%
1573,1305,902,898,4,69.12%
1574,1042,690,682,8,66.22%
1575,1154,783,771,12,67.85%
1576,1084,750,743,7,69.19%
1577,1122,820,816,4,73.08%
1578,801,535,530,5,66.79%
1579,573,381,370,11,66.49%
1580,580,381,379,2,65.69%
